1111111111111
1001000000C1
10000111110F1
1P0011E000001
1111111111111